#^.^~****^*~~.~^~..~~~^~.^~.*~**.^^*^*^~..*^^..~^.
*#*~*.~^^^~~.*~*.**.~~^*^**.^~*^^.*^...^..^.**.~^*
^^#**~.*^*^..^**.~~~.~*.~^^~^~^.^~^*~**.~*^.^**.*.
*~~#~^.~*~^~^^*^**.~.*^^*~~^^*~.^.*^^*^.^.~~^^^*~.
*.^~#^.~^.^.^^*~^~~*^..^~^~~^.*^^..**.**~.~~^~*~**
^.^^~#.*~**.*~*^*~^*~~^.^.~.~^**~.^^^^*.~.~~~^^.^.
*~~.*#^~~~^*.^*~~~*^.^**^*^.^.^~~***^^*^.~^^.^^.~.
.~.*~~#*.**.~^^~**^.^.^~~~^.~.^~~^^.~^^.^^~.~.~.*^
.^^^~~#~.^.~.*~.~~..~*~^.~**~..^****~.*~^~~*~**^~^
^^^*^^*#...*.^^*^^^.*~*~^^~*~~.~****~~~~***.^^~~^~
..*^^^^^#^~.^~.^.^^~*~^*~**^*^.~~~*^.^^~**~*~.....
**.^~~~^~#~****.**^~.^.*^^^~.^...~.**^^^^~^.~^~.~*
^*~.*.~*^#~.^^^^^*~.**~^.*^*.~~..^~~~*~*^.~~^*^*^^
~*^.^..**~#*#*^~***^~~*^*.*~..~^^***^.*~.^*^^^^.~.
*~^~^**^^*^#~#*~^^*~~~*^*~~~~*~^^^*~..~~~~~.*~^~*.
^.*.^*^**^^^~*#.*.~^~~~^..~~~*~~^*~..^^.^~*.^~^~**
.***^..*^~~~~^~#*^~~.*.~^.^^*.***^~^.*....~.^.*~^^
^^~~~~.**.*.^^*#^~~^....*~*^~*^^.^~~~^*.~^^^~**^~~
^~~*^*.~.*^^^*^.##.~*...~**^.^^~.^^.^..^.^**.^^..*
~^***~^.~.~^^^*~~~#*..^~^^.~^.~.**...~^~**~^~~**^~
~~~^~.^*.^*.~*.*~~^#.~*^^~~**.*.*.~^^^..^.~^.*.^~~
^^~...^.*~.^^**~^~*.#^~^~*....^.^^**~.*.^^*..~*~.*
^..^...~.~.*.~***~*~~#..~*~^^~~^~**^~~^*^^~*.~*^*^
*^.**^~*****.~~~..~^~.#.^*~^.^^*^..*~^.^.^*.^.~^^*
~...~*^....*^.*^^*...^#~~..^.*~.*~.*^.^*^*^.****^~
^..~***^.*^~~.****.~*^#~.^~*.~^*^~^.****~..~*..*^~
.~^~**~^^..~~~^..*~*.^*#~..^^*.~.*..*~~*~.^~.~*~~.
.***~..~**^.~.~.~*.~~**.#^.^~..~*~~~~*.**~~^..^.^^
~.*.~^*^*~^.~*..*~^~~.*.*#.*.*..^~.*~^^*.~^.^~^**^
.*^~^^*.^*.~*...*~~~*.**.~#..*.*^.^*.^*~*.^~^**^*.
.~..*....~..~.***~..~^..~~^#^*^~^^~~**^.*~**^**^^*
^.*.~.^.**^*^.~^^*.~..*^~*^*##.~**..^.~~*..^*^~*.~
^~~^~~*.~^^~~^**.^.^^^*^.*^^~~#^#*~^*^^..**..**..^
^.^*.*^..*.~~.^^***^.*~..~.**^*#~#...^^~*.~^~^..~~
~^^.^..*^^.**.~~^*~*^~*~^~~.~*.^~#~*^~*.*..^.^^*^*
^^.~*^~~*.~~*~.^..~*.^.~**.^*^.^~.#*.~*.~...~~..*.
.~..^.~.~.^*.~^*~.~.*^*~~*.^.*****#~*~~*^~~~^.~~*~
~.*..^^*^~*.~~.~.^~..~.~^^^.*~*.**~#*~*^*^^~..^~^^
*.^*^**^*.^^*....**..~^^~.^*^.*~*^**#^..*.^^*^^^.~
^*^~^^*.~*~^*~^~~.*.^*^~*^^~.*~.*~.**#*~^~~.~*^~~*
~~**~*.^.*~..~~^^^~^^^.~***^*.^*~^*~^~#~**...~..~.
*~**^~~.^.*.~^**~*^^.*^*.^~~*~~~*^.*.#~~^*^.*^.^.*
.*^~..*~.*^^^^^~~^^*.~*.~~~.***~^.*.#~~******~~^*.
.^^..^.^*^~^.~*...**~~~.**^*~~~*^***~#*^~^~~^^^*.*
**.**~.**~.*.*^~~.~^.*^.~~*.^*.~.***~*#^..~*.~*^*^
~..^.****^.****~^~***..^^^^*^.~*^^*.~~#^**^*~^*.~~
^*~^.~*...^^.^~.^^..~^...**...^****^*~#~#^..~^*~.~
...^~^.~^^~~~~.*^~.^~***~~^^^.*^^.~.^*~#~##^***^~^
.~~~~~^^.~~*^.~^^^**~^~.^~^~*..^*~^^*..*~^~###*#^.
~^**.~**..*^~^^^.^*^~^~*^.~*~.^.**.^.^^.~**^~~#~##
